NO textures/simonkraft/respawn_anchor_side0.xpm
EA textures/simonkraft/respawn_anchor_side2.xpm
SO textures/simonkraft/respawn_anchor_side4.xpm
WE textures/simonkraft/respawn_anchor_side3.xpm

C 35,19,73
F 15,6,40


111111111111111111111
110000000000000000001
110000000000000010001
100000000000000011001
100111000100000000001
100000001000000001001
101100001000000111001
100000001000000010001
100111001000000100001
100000001000000000N01
100100000011100000001
111111111111111111111