NO textures/simonkraft/respawn_anchor_side0.xpm
EA textures/simonkraft/respawn_anchor_side2.xpm
SO textures/simonkraft/respawn_anchor_side4.xpm
WE textures/simonkraft/respawn_anchor_side3.xpm

C 35,19,73
F 15,6,40


11111111111111111111111111
11000000000000000000000001
110000E0000000000000000001
10000000000000000000000001
10000000000000000000000001
10000000000000000100000001
10000000000000000000000001
10000000000000000000000001
10000000000000000000000001
10000000000000000000000001
10010000000000000000000001
11111111111111111111111111