F 255,255,             255
C 225,30,0  6464

NO ./path_to_the_north_texture
SO ./path_to_the_south_texture
WE ./path_to_the_west_texture
EA ./path_to_the_east_texture


11111111111
100S01     101
11101111111
11001111111
100001
  11111111111