NO mandatory/textures/elbaph.png
EA mandatory/textures/elbaph.png
SO mandatory/textures/elbaph.png
WE mandatory/textures/elbaph.png

C 0,0,12
F 101,67,33


111111111111
100000001101
100000001101
100000001101
100000001101
100000001101
10N000000001
111111111111