NO mandatory/textures/wall2.png
SO mandatory/textures/wall2.png
WE mandatory/textures/wall2.png
EA mandatory/textures/wall2.png

F 18,53,25
C 153,204,255

111111111111
1       1111
111111110001
100000010011
10S000000001
111111111111
11         1
111111111111