F 76,76,76
C 99,99,99

NO bonus/textures/wall1.png
EA bonus/textures/wall1.png
SO bonus/textures/wall1.png
WE bonus/textures/wall1.png
D bonus/textures/doors/door.png
SP bonus/textures/enemy/m4.png

1111111111111111111
10W1001001001000001
101100000A000001001
10010010011D1101111
10011A1000001001001
1000000000000001001
100111D111111001001
1111000000000001011
10000001A1000000011
1111111111111111111

