NO bonus/textures/wall5.png
EA bonus/textures/wall5.png
SO bonus/textures/wall5.png
WE bonus/textures/wall5.png
D bonus/textures/doors/door3.png
SP bonus/textures/enemy/m4.png
F 0,0,0


C 4,4,7

1111111111
100S000001
1000000001
11111D1111
1000000001
1000000001
1000000001
1000000001
11111111D1
1000000001
1000000001
1000000001
1111111111











