NO bonus/textures/wall6.png
EA bonus/textures/wall6.png
SO bonus/textures/wall6.png
WE bonus/textures/wall6.png
D bonus/textures/doors/door8.png
SP bonus/textures/enemy/m4.png

C 0,0,0
F 0,0,0

1111111111111111111111111111111111111111111111111111111111111111111111111
100000000000000000000000000000000000A000000000000000000000000000000000001
100000000000000000000000000000000000A000000000000000000000000000000000001
100000000000000000000000000000000000A000000000000000000000000000000000001
100000000000000S00000000000000000000A000000000000000000000000000000000001
100000000000000000000000000000000000A000000000000000000000000000000000001
100000000000000000000000000000000000A000000000000000000000000000000000001
100000000000000000000000000000000000A000000000000000000000000000000000001
100000000000000000000000000000000000A000000000000000000000000000000000001
100000000000000000000000000000000000A000000000000000000000000000000000001
100000000000000000000000000000000000A000000000000000000000000000000000001
100000000000000000000000000000000000A000000000000000000000000000000000001
100000000000000000000000000000000000A000000000000000000000000000000000001
100000000000000000000000000000000000D000000000000000000000000000000000001
100000000000000000000000000000000000A000000000000000000000000000000000001
100000000000000000000000000000000000A000000000000000000000000000000000001
100000000000000000000000000000000000A000000000000000000000000000000000001
100000000000000000000000000000000000A000000000000000000000000000000000001
100000000000000000000000000000000000A000000000000000000000000000000000001
100000000000000000000000000000000000A000000000000000000000000000000000001
100000000000000000000000000000000000A000000000000000000000000000000000001
100000000000000000000000000000000000A000000000000000000000000000000000001
100000000000000000000000000000000000A000000000000000000000000000000000001
100000000000000000000000000000000000A000000000000000000000000000000000001
100000000000000000000000000000000000A000000000000000000000000000000000001
1111111111111111111111111111111111111111111111111111111111111111111111111