NO bonus/textures/wall1.png
EA bonus/textures/wall1.png
SO bonus/textures/wall1.png
WE bonus/textures/wall1.png
D bonus/textures/doors/door1.png
SP bonus/textures/enemy/m4.png

F 0,0,0
C 4,4,7

         
  1111111111111111111111111   
  1001100000000000000000011
  1001111110000000000000001
  10010000D0000101000011111
  100111A110000000010100001
  1000000000000000010100001
  1001111110000000010100001
  1000000D000011100001D1111
  11D1111100000000000000001
  1000000D00000000000111111
  1111110111000000000D000E1
  1000110111001100000111101
  1001000000001A00011000001
  1001000000001100011000001
  1000111111001100000111101
  1001111111000000010000001
  1000000000000000000011111
  1001111100000000000000001
  1000000000001A10000001111
  1001111100000000010100001
  1001000000000101000000111
  1111111111111111111111111   

