NO bonus/textures/wall8.png
EA bonus/textures/wall8.png
SO bonus/textures/wall8.png
F 74, 4, 4
C 0, 0, 0
WE bonus/textures/wall8.png
D bonus/textures/doors/door9.png
SP bonus/textures/enemy/m5.png



111111111111   
111111111111
100011100001
100100000001
100011110001
100000000001
10011A110001
100000000001
100000000001
10000000001
100000000001
100000000001
1000000000011111111
10000N00000D00000001
10110100000111111111
101000000001
10A000000001
101000000001
100001011101
 1111 11  1 


   