

F 74, 4, 4
NO      bonus/textures/wall8.png
EA bonus/textures/wall8.png
SO bonus/textures/wall8.png
WE       bonus/textures/wall8.png
D bonus/textures/doors/door9.png
SP bonus/textures/enemy/m5.png
C 0,0,0
                1111111111111111111111111
                1000100000110000000001001
                1011000001110000000000001
                1001000000000001001000001
        111111111011000001110000000000001
        100000000011000001110111111111111
        11110111111111011100000010001
        11110111111111011101010010001
        11000000110101011100000010001
        10000100000000001100000000001
        10000010000000001101010010001
        1100000111010101011101111000111
        11110111 11101010101111010001
        11111111111111110111111111111
               101111111111111111111111111111111111111111111111111111    1    1
               10111111111111111111110000011101010101001010101001010111110111101111111
               101111111111111111111101111111111111111111111111111111111111 1 1
               1000000000000000000000000000000DDDDDDDDDDDDDDDDDDDDDDDDDD0111011111111
               1111111111111111100011111000001111111111111111111111111111111111111111111111 1 1 1 1 1 1 1 1 1 1 1 1 1 1 1 1 1 1 1 1 1 1 1 1 1 1 1
               111111011111111111D1011111000011111111111111111111111                       
               11111101111111111000111111000011111111111111111111111                      
               1111111111111100000111111011110111100000111000001                            1 1 1 1 1 1 1 1 1 1 1 1 1 1 1 1 1 1 1 1 1 1 1
 111111 11 11 11111111111111111D111111111111111111111111111111111111111111111
1010000100100100000000000000000000000000000000000000000000111111111111
1111111111111111111111111000001D1000111111111111111111111111111111111111111
111111011111111111111111110000100001D11111111111111111
111111111111110000111111101110111100000111000001
              1111111111111111111111111111111111111111111111111111111111
                                                  111111 11111 1111111111111111111111111111111111111111111111111111111111111111
                                                 1010000100100100000000000000000000000000000000000000000000111111111111
                        11111111111111111111111110000011111111111111111111111111111111111111111111111111111
                   11111101111111111111111111000011111111111111111111111
                1111111111111100001111111001110111100000111000001
                11111110000010111010101010100101010101010101010101111111111111111111111111111111
              1111111111111111111111111111111111111111111111111111111111
              11111111111111111111111111111111111111111111111111111111111111111111111111111111111111111111111111111111111111111111111111111111111111111111111111111111111111111111111111111111111111111111111111111111111111111111111111111111111111111111111111111111111111111111111111111111111111111111111111
              1000000000000000000000001010111101111111
              111111111111111111111111111111  1
                1111111111111111111111111
                1000100000110000000001001
                1011000001110000000000001
                1001000000000001001000001
        111111111011000001110000000000001
        100000000011000001110111111111111
        11110111111111011100000010001
        11110111111111011101010010001
        11000000110101011100000010001
        10000100000000001100000000001
        10000010000000001101010010001
        1100000111010101011101111000111
        11110111 11101010101111010001
        11111111111111110111111111111
               101111111111111111111111111111111111111111111111111111    1    1
               10111111111111111111110000011101010101001010101001010111110111101111111
               101111111111A11111111101111A11111111111111111111111111111111 1 1
               100000000000000000S000000000000DDDDDDDDDDDDDDDDDDDDDDDDDD0111011111111
               11111111111A11111000111A1000001111111111111111111111111111111111111111111111 1 1 1 1 1 1 1 1 1 1 1 1 1 1 1 1 1 1 1 1 1 1 1 1 1 1 1
               111111011111111111D1011111000011111111111111111111111                       
               11111101111111111000111111000011111111111111111111111                      
               1111111111111100000111111011110111100000111000001                            1 1 1 1 1 1 1 1 1 1 1 1 1 1 1 1 1 1 1 1 1 1 1
 111111 11 11 11111111111111111D111111111111111111111111111111111111111111111
1010000100100100000000000000000000000000000000000000000000111111111111
1111111111111111111111111000001D1000111111111111111111111111111111111111111
111111011111111111111111110000100001D11111111111111111
111111111111110000111111101110111100000111000001
              1111111111111111111111111111111111111111111111111111111111
                                                  111111 11111 1111111111111111111111111111111111111111111111111111111111111111
                                                 1010000100100100000000000000000000000000000000000000000000111111111111
                        11111111111111111111111110000011111111111111111111111111111111111111111111111111111
                   11111101111111111111111111000011111111111111111111111
                1111111111111100001111111001110111100000111000001
                11111110000010111010101010100101010101010101010101111111111111111111111111111111
              1111111111111111111111111111111111111111111111111111111111
              11111111111111111111111111111111111111111111111111111111111111111111111111111111111111111111111111111111111111111111111111111111111111111111111111111111111111111111111111111111111111111111111111111111111111111111111111111111111111111111111111111111111111111111111111111111111111111111111111
              1000000000000000000000001010111101111111
              111111111111111111111111111111  1